############
#  -#      #
# ### #### #
# #   #    #
# # #### ###
#   #  # # #
#####  # # #
# -      - #
# # #  #####
# # #  #-  #
#   #     $#
############
