#####
#   #
#   #
#~  #
#   #
#  $#
#####